0000000000000000000000000000000000000000000000000000000
0000000000000000000000000000000000000000000000000000000
0000000000000000000000000000000000000000000000000000000
0000000000000000000000000000000000000000000000000000000
0000000000000000000000000000000000000000000000000000000
0000000000000000000000000000000000000000000000000000000
0000000000000000000000000000000000000000000000000000000
0000000000000000000000000000000000000000000000000000000
0000000000000000000000000000000000000000000000000000000
0000000000000000000000000000000000000000000000000000000
0000000022222222222222000000000000000000222222222200000
0000000211111111111111222222000000000002111111111100000
2222222111111111111111111111000000000001111111111100000
0000000111111111111111111111000000000001111111111100000
0000000111111111111111111111000000000001111111111100000
0000000111111111111111111111000000000001111111111100000
0000000111111111111111111111000000000001111111111100000
0000000111111111111111111111000000000001111111111100000
0000000111111111111111111111000000000001111111111100000
0000000111111111111111111111000000000001111111111100000